2 2 2 2 2 2 2 2 2 2 2 2 2 2 2 2 2 2 2 2 2 2 2 2 2 2 2 2 2 2 2 2
2 7 7 1 1 1 7 1 1 7 4 4 4 4 4 1 7 7 1 6 6 6 6 1 1 1 6 1 1 7 1 2
2 1 1 1 7 1 1 1 1 1 4 4 4 4 4 6 1 1 1 6 6 6 1 7 1 6 6 6 1 7 1 2
2 1 7 7 7 7 7 5 5 5 5 5 5 5 5 6 6 6 6 6 6 6 6 7 6 6 6 6 6 1 1 2
2 1 1 7 1 1 7 5 1 1 4 4 4 4 4 6 6 1 7 7 1 6 6 6 6 6 6 6 6 6 6 2
2 7 1 7 1 7 7 5 1 7 4 4 4 4 4 4 4 4 4 4 4 4 4 4 4 4 4 4 4 4 4 2
2 1 1 7 1 1 7 5 1 1 4 4 4 4 4 4 4 4 4 4 4 4 4 4 4 4 4 4 4 4 4 2
2 1 7 7 7 1 7 5 1 1 4 4 4 4 4 4 4 4 4 4 4 4 4 4 4 4 4 4 4 4 4 2
2 1 1 1 1 1 7 5 1 1 4 4 4 4 4 4 4 4 4 4 4 4 4 4 4 4 4 4 4 4 4 2
2 3 3 3 3 3 3 5 3 3 3 3 3 3 3 1 1 1 7 1 1 1 1 1 7 4 4 4 4 4 4 2
2 3 3 3 3 3 3 5 3 3 3 3 3 3 3 1 1 1 1 1 1 1 1 1 1 4 4 4 4 4 4 2
2 3 3 3 3 3 3 5 3 3 3 3 3 3 3 1 1 1 1 1 1 7 1 1 1 4 4 4 4 4 4 2
2 3 3 3 3 3 3 5 3 3 3 3 3 3 3 4 4 4 5 4 4 4 4 4 4 4 4 4 4 4 4 2
2 7 7 1 1 1 1 5 1 1 1 1 1 1 1 4 4 4 5 4 4 4 4 4 4 4 4 4 4 4 4 2
2 1 1 1 1 1 1 5 1 1 1 1 7 1 1 4 4 4 5 4 1 1 1 1 1 1 1 1 1 7 7 2
2 1 7 1 1 1 1 5 1 1 1 1 1 1 1 4 4 4 5 4 4 4 4 4 4 7 7 7 1 1 1 2
2 1 1 1 1 1 1 5 5 5 5 5 5 5 5 5 5 5 5 5 5 5 5 5 5 1 1 1 1 1 7 2
2 1 1 7 1 1 1 1 1 7 1 1 1 1 1 4 4 4 4 4 4 4 4 4 4 1 7 1 1 7 7 2
2 1 1 1 1 1 1 1 1 1 1 1 1 1 1 1 1 1 1 2 2 2 2 2 2 2 2 2 2 2 2 2
2 5 5 5 5 5 5 5 5 5 5 5 5 5 5 5 5 5 5 5 5 5 5 5 5 5 5 5 5 5 5 2
2 5 5 5 5 5 5 5 5 5 5 5 5 5 5 5 5 5 5 5 5 5 5 5 5 5 5 5 5 5 5 2
2 3 3 3 3 3 3 3 3 3 3 3 3 3 3 3 3 3 3 3 3 3 3 3 3 3 3 3 3 3 3 2
2 3 3 3 3 3 3 3 3 3 3 3 3 3 3 3 3 3 3 3 3 3 3 3 3 3 3 3 3 3 3 2
2 3 3 3 3 3 3 3 3 3 3 3 3 3 3 3 3 3 3 3 3 3 3 3 3 3 3 3 3 3 3 2